57
XXXXXXX
XXX**TX
XXX*XXX
XXX***X
XXXXXSX